7,1,1,1,1, 1,1,1,1,1, 1,1,1,1,1, 1,1,1,1,1,  1,1,1,1,1, 1,1,1,1,1, 1,1,1,1,1, 1,1,1,1,7,
1,0,0,0,0, 0,0,0,0,0, 0,0,0,0,0, 0,0,0,0,0,  0,0,0,0,0, 0,0,0,0,0, 0,0,0,0,0, 0,0,0,0,1,
1,0,0,0,0, 0,0,0,0,0, 0,0,0,0,0, 0,0,0,0,0,  0,0,0,0,0, 0,0,0,0,0, 0,0,0,0,0, 0,0,0,0,1,
1,0,0,0,0, 0,0,0,0,0, 0,0,0,0,0, 0,0,0,0,0,  0,0,0,0,0, 0,0,0,0,0, 0,0,0,0,0, 0,0,0,0,1,
1,0,0,0,0, 0,0,0,0,0, 0,0,1,1,1, 1,4,0,0,4,  0,0,0,0,0, 0,0,0,0,0, 0,0,0,0,5, 5,5,0,0,1,

1,0,0,0,0, 0,0,0,0,0, 0,0,0,0,0, 1,4,0,0,4,  0,0,0,0,0, 0,0,0,0,0, 0,0,0,0,5, 6,5,0,0,1,
1,0,0,0,0, 0,0,0,0,0, 0,0,0,0,0, 1,4,4,0,0,  0,0,0,0,0, 0,0,0,0,0, 0,0,0,0,5, 5,5,0,0,1,
7,1,1,1,0, 0,0,0,0,0, 0,0,0,0,0, 1,0,4,4,0,  0,0,0,0,0, 0,0,0,0,0, 0,0,0,0,5, 5,5,0,0,1,
1,0,0,0,0, 0,0,0,0,0, 0,0,0,0,0, 1,0,0,4,4,  0,0,0,0,0, 0,0,0,0,0, 0,0,0,0,5, 5,5,0,0,1,
1,0,0,0,0, 0,0,1,1,1, 0,0,0,0,0, 1,0,0,0,4,  0,0,0,0,0, 0,1,1,1,0, 0,0,0,0,0, 0,0,0,0,1,

1,0,0,0,0, 0,0,0,0,0, 0,0,0,0,0, 1,4,4,0,0,  1,1,1,0,0, 0,0,0,1,0, 0,0,0,0,0, 0,0,0,0,1,
1,0,0,0,0, 0,0,0,0,0, 0,0,0,0,0, 1,0,4,4,0,  0,0,0,0,0, 0,0,0,1,0, 0,0,1,1,1, 1,1,1,1,1,
1,0,0,0,0, 0,0,0,0,0, 0,0,0,0,0, 1,0,0,4,4,  0,0,0,0,0, 0,1,1,1,0, 0,0,0,0,0, 0,0,0,0,1,
1,0,0,0,0, 0,0,0,1,1, 1,1,0,0,0, 1,0,0,0,4,  0,0,0,0,0, 0,0,0,0,0, 0,0,0,0,0, 0,0,0,0,1,
1,0,0,0,0, 0,0,0,0,0, 0,0,0,0,0, 1,0,0,0,0,  1,1,1,0,0, 0,0,0,0,0, 0,0,0,0,0, 0,0,0,0,1,

1,0,0,0,0, 0,1,1,0,0, 0,0,0,0,0, 1,0,0,0,0,  0,0,0,0,0, 0,0,0,0,0, 0,0,0,0,0, 0,0,0,0,1,
1,0,0,0,0, 0,0,0,0,0, 0,0,0,0,0, 1,0,0,0,0,  0,0,0,0,0, 1,0,0,0,0, 0,0,0,0,0, 0,0,0,0,1,
1,0,0,0,0, 0,0,0,0,0, 0,0,0,0,0, 1,0,0,6,0,  0,0,0,0,0, 0,0,0,1,1, 1,0,0,0,0, 0,0,0,0,1,
1,0,0,0,0, 0,0,0,0,0, 0,0,0,0,0, 1,0,0,0,0,  0,0,0,0,0, 0,0,0,0,0, 0,0,0,0,0, 0,0,0,0,1,
7,1,1,1,1, 1,0,0,0,0, 0,0,0,0,0, 1,1,1,1,1,  1,1,1,1,0, 0,0,0,0,0, 0,0,0,0,0, 0,0,0,0,1,


1,0,0,0,0, 0,1,0,0,0, 0,0,0,0,0, 0,1,0,0,0,  0,0,0,0,0, 0,0,0,0,0, 0,0,0,0,0, 0,0,0,0,1,
1,0,0,0,0, 0,0,1,0,4, 0,0,4,0,0, 0,1,0,0,0,  0,0,0,0,0, 0,0,0,0,0, 0,0,0,0,0, 0,0,0,0,1,
1,0,0,0,0, 0,0,0,1,6, 0,5,4,0,0, 0,1,0,0,0,  6,0,0,0,0, 0,0,0,0,0, 0,0,0,0,0, 0,0,0,0,1,
1,0,0,0,0, 0,0,0,0,1, 1,1,0,0,0, 0,1,0,0,0,  1,1,1,0,0, 0,0,0,1,0, 0,0,0,0,0, 0,0,0,0,1,
1,0,0,0,0, 0,0,0,0,0, 0,0,0,0,0, 0,1,0,0,0,  0,0,0,1,0, 0,0,1,0,0, 0,0,0,0,0, 0,0,0,0,1,

1,0,0,0,0, 0,0,0,0,0, 0,0,4,0,0, 0,1,0,0,0,  0,0,0,0,1, 0,1,0,0,0, 0,0,0,0,0, 0,0,0,0,1,
1,0,1,1,0, 0,1,1,0,0, 1,1,1,0,0, 1,1,0,0,0,  0,0,0,0,0, 1,0,0,0,0, 0,0,0,1,1, 1,1,1,1,7,
1,5,0,0,0, 0,0,0,0,0, 0,0,0,0,0, 0,0,0,0,0,  0,0,0,0,0, 0,0,0,0,0, 0,0,1,7,7, 7,7,7,7,7,
1,5,0,0,0, 0,0,0,0,0, 0,0,0,0,0, 0,0,0,0,0,  0,0,0,0,0, 0,0,0,0,0, 0,1,2,2,2, 2,2,2,2,7,
7,1,1,1,0, 0,0,0,0,0, 0,0,0,0,0, 0,0,0,0,0,  0,0,0,0,0, 0,0,0,0,0, 1,7,2,2,2, 2,2,2,2,7,

7,7,7,7,1, 0,0,0,0,0, 0,0,0,0,0, 0,0,0,0,0,  0,0,0,0,0, 0,0,0,0,1, 7,7,2,2,2, 2,2,2,2,7,
7,7,7,7,7, 1,0,0,0,0, 0,0,0,0,0, 0,0,0,0,0,  0,0,0,0,0, 0,0,0,1,7, 7,7,2,2,2, 2,2,2,2,7,
7,7,7,7,7, 7,1,0,0,0, 0,0,0,0,0, 0,0,0,0,0,  5,1,1,1,1, 1,1,1,1,1, 1,1,1,1,1, 1,1,1,1,7,
7,7,7,7,7, 7,1,0,0,0, 0,0,0,0,0, 0,0,0,0,0,  5,0,0,0,0, 0,0,0,0,0, 0,0,0,0,0, 0,0,0,0,1,
7,7,7,7,7, 7,1,0,0,0, 0,0,0,0,0, 0,0,0,0,0,  5,0,0,0,0, 0,0,0,0,0, 0,0,0,0,0, 0,0,0,0,1,

7,7,7,7,7, 7,1,0,0,0, 0,0,0,0,0, 0,0,0,0,1,  1,0,0,0,0, 0,0,0,0,1, 1,0,0,0,0, 0,0,0,0,1,
7,7,7,7,7, 7,1,0,0,0, 0,0,0,0,0, 0,0,0,1,7,  7,1,0,0,0, 0,0,0,1,7, 1,0,0,0,0, 0,0,0,0,1,
7,7,7,7,7, 7,1,0,0,0, 0,0,0,0,0, 0,0,1,7,7,  7,7,1,0,0, 0,0,1,7,7, 1,0,0,0,0, 0,0,0,0,1,
7,7,7,7,7, 7,1,0,0,0, 0,0,0,0,0, 0,1,7,7,7,  7,7,7,1,0, 0,1,7,7,7, 1,0,0,0,0, 0,0,0,0,1,
7,7,7,7,7, 7,7,1,1,1, 1,1,1,1,1, 1,7,7,7,7,  7,7,7,7,1, 1,7,7,7,7, 7,1,1,1,1, 1,1,1,1,7,

0...空白　1...ブロック　2...ドラ&ドロ　3...コピー　4...破壊　5...梯子　6...ゴール   7...当たり判定なしブロック

