7,1,1,1,1, 1,1,1,1,1, 1,1,1,1,1, 1,1,1,1,1,  1,1,1,1,1, 1,1,1,1,1, 1,1,1,1,1, 1,1,1,1,7,
1,0,0,0,0, 0,0,0,0,0, 0,0,0,0,0, 0,0,0,0,0,  0,0,0,0,0, 0,0,0,0,0, 0,0,0,0,0, 0,0,0,0,1,
1,0,0,0,0, 0,0,0,0,0, 0,0,0,0,0, 0,0,0,0,0,  0,0,0,0,0, 0,0,0,0,0, 0,0,0,0,0, 0,0,0,0,1,
1,0,0,0,0, 0,0,0,0,0, 0,0,0,0,0, 0,0,0,0,0,  0,0,0,0,0, 0,0,0,0,0, 0,0,0,0,0, 0,0,0,0,1,
1,0,0,0,0, 0,0,0,0,0, 0,0,0,0,0, 0,0,0,0,0,  0,0,0,0,0, 0,0,0,0,0, 0,0,0,0,0, 0,0,6,0,1,

1,0,0,0,0, 0,0,0,0,0, 0,0,0,0,0, 0,0,0,0,0,  0,0,0,0,0, 0,0,0,0,0, 0,0,0,0,0, 3,1,1,1,1,
1,0,0,0,0, 0,0,0,0,0, 0,0,0,0,0, 0,0,0,0,0,  0,0,0,0,0, 0,0,0,0,0, 0,0,0,0,3, 3,1,1,1,1,
1,0,0,0,0, 0,0,0,0,0, 0,0,0,0,0, 0,0,0,0,0,  0,0,0,0,0, 0,0,0,0,0, 0,0,0,0,0, 0,0,0,0,1,
1,0,0,0,0, 0,0,0,0,0, 0,0,0,0,0, 0,0,0,0,0,  0,0,0,0,0, 0,0,0,0,0, 0,0,0,0,0, 0,0,0,0,1,
1,0,0,0,0, 0,0,0,0,0, 0,0,0,0,0, 0,0,0,0,0,  0,0,0,0,0, 0,0,0,0,0, 0,1,0,0,0, 0,0,0,0,1,

1,0,0,0,0, 0,0,0,0,0, 0,0,0,0,0, 0,0,0,0,0,  0,0,0,0,0, 0,0,0,0,0, 1,1,0,0,0, 0,0,0,0,1,
1,0,0,0,0, 0,0,0,0,0, 0,0,0,0,0, 0,0,0,0,0,  0,0,0,0,0, 0,0,0,0,1, 1,1,0,0,0, 0,0,0,0,1,
1,0,0,0,0, 0,0,0,0,0, 0,0,0,0,0, 0,0,6,0,0,  0,0,0,0,0, 0,0,0,1,1, 1,1,0,0,0, 0,0,0,0,1,
1,0,0,0,0, 0,0,0,0,0, 4,4,4,1,1, 1,1,1,1,1,  1,1,0,0,0, 0,0,1,1,1, 1,1,0,0,0, 0,0,0,0,1,
1,0,0,0,0, 0,0,0,0,4, 4,4,4,1,7, 7,7,7,7,7,  7,7,1,0,0, 0,0,0,0,0, 0,0,0,0,0, 0,0,0,0,1,

1,0,0,0,0, 0,0,0,4,4, 4,4,4,1,7, 7,7,7,7,7,  7,7,7,1,0, 0,0,0,0,0, 0,0,0,0,0, 0,0,0,0,1,
1,0,0,0,0, 0,0,4,4,4, 4,4,4,1,7, 7,7,7,7,7,  7,7,7,7,1, 0,0,0,0,0, 0,0,0,0,0, 0,0,0,0,1,
1,0,0,0,0, 0,4,4,4,4, 4,4,4,1,7, 7,7,7,7,7,  7,7,7,7,7, 1,0,0,0,0, 0,0,0,0,0, 0,0,0,0,1,
1,0,0,0,0, 0,4,4,4,4, 4,4,4,1,7, 7,7,7,7,7,  7,7,7,7,7, 7,1,0,0,0, 0,0,0,0,0, 0,0,0,0,1,
1,5,1,1,1, 1,1,1,1,1, 1,1,1,1,1, 1,1,1,1,1,  1,1,1,1,1, 1,1,1,1,1, 1,1,1,1,1, 1,1,1,1,7,


1,5,0,0,0, 0,0,0,0,0, 0,0,0,0,1, 0,0,0,0,0,  0,0,0,0,0, 0,0,0,0,0, 0,0,0,0,0, 0,0,0,0,1,
1,5,0,0,0, 0,0,0,0,0, 0,0,0,0,1, 0,0,0,0,0,  0,0,0,0,0, 0,0,0,0,0, 0,0,0,0,0, 0,0,0,0,1,
1,5,0,0,0, 0,0,0,0,0, 0,0,0,0,1, 0,0,0,0,0,  0,0,0,0,0, 0,0,0,0,0, 0,0,0,0,0, 0,0,0,0,1,
1,5,0,0,6, 0,0,0,0,0, 0,0,0,0,1, 0,0,0,0,0,  0,0,0,0,0, 0,0,0,0,0, 0,0,0,0,0, 0,0,0,0,1,
7,1,1,1,1, 1,1,1,1,1, 1,5,1,1,1, 0,0,0,0,0,  0,0,0,0,0, 0,0,0,0,0, 0,0,0,0,0, 0,0,0,0,1,

1,1,1,1,3, 0,0,0,0,0, 0,0,0,0,0, 0,0,0,0,0,  0,0,0,0,0, 0,0,0,0,0, 0,0,0,0,0, 0,0,0,0,1,
1,0,0,0,0, 3,0,0,0,0, 0,0,0,0,0, 0,0,0,1,0,  0,0,0,0,0, 0,0,0,0,0, 0,0,0,0,0, 0,0,0,0,1,
1,0,0,0,0, 0,3,0,0,0, 0,0,0,0,0, 0,0,0,1,0,  0,0,0,0,0, 0,0,0,0,0, 0,0,0,0,0, 0,0,0,0,1,
1,0,0,0,0, 0,0,0,0,0, 0,0,0,0,0, 0,0,0,1,0,  0,0,0,0,0, 0,0,0,0,0, 0,0,0,0,0, 0,0,0,0,1,
1,0,0,0,0, 0,0,0,0,1, 1,1,1,1,1, 1,1,1,1,0,  0,0,0,0,0, 0,0,0,0,0, 0,0,0,0,0, 0,0,0,0,1,

1,0,0,0,0, 0,0,0,0,0, 0,5,0,0,0, 0,0,0,0,0,  0,0,0,0,0, 0,0,0,0,0, 0,0,0,0,0, 0,0,0,0,1,
1,0,0,0,0, 0,0,0,0,0, 0,5,0,0,0, 0,0,0,0,0,  0,0,0,0,0, 0,0,0,0,0, 0,0,0,0,0, 0,0,0,0,1,
1,0,0,0,0, 0,0,0,0,0, 0,5,0,0,0, 0,0,0,0,0,  0,0,0,0,0, 0,0,0,0,0, 0,0,0,0,0, 0,0,0,0,1,
1,0,0,0,0, 0,0,0,0,0, 0,5,0,0,0, 0,0,0,0,0,  0,0,0,0,0, 0,0,0,0,0, 0,0,0,0,0, 0,0,0,0,1,
1,0,0,0,0, 0,0,0,0,0, 1,1,0,0,0, 0,0,0,0,0,  0,0,0,0,0, 0,0,0,0,0, 0,0,0,0,0, 0,0,0,0,1,

1,0,0,0,0, 0,0,0,0,1, 7,1,0,0,0, 0,0,0,0,0,  0,0,0,0,0, 0,0,0,0,0, 0,0,0,0,0, 0,0,0,0,1,
1,0,0,0,0, 0,0,0,1,7, 7,1,0,0,0, 0,0,0,0,0,  0,0,0,0,0, 0,0,0,0,0, 0,0,0,0,0, 0,0,0,0,1,
7,1,1,1,5, 1,1,1,1,1, 1,1,0,0,0, 0,0,0,0,0,  0,0,0,0,0, 0,0,0,0,0, 0,0,0,0,0, 0,0,0,0,1,
1,0,0,0,5, 0,0,0,0,0, 0,0,0,0,0, 0,0,0,0,0,  0,0,0,0,0, 2,2,0,0,0, 0,0,0,0,0, 0,0,0,0,1,
1,0,0,0,5, 0,0,0,0,0, 0,0,0,0,0, 0,0,0,0,0,  0,0,6,0,0, 2,2,0,0,0, 0,0,0,0,0, 0,0,0,0,1,

1,0,0,0,5, 0,0,0,0,0, 0,0,0,0,0, 0,0,0,1,1,  1,1,1,1,1, 1,1,1,0,0, 0,0,0,0,0, 0,0,0,0,1,
1,0,0,0,5, 0,0,0,0,0, 0,0,0,0,0, 0,0,1,7,7,  7,7,7,7,7, 7,7,7,1,0, 0,0,0,0,0, 0,0,0,0,1,
1,0,0,0,5, 0,0,0,0,0, 0,0,0,0,0, 0,1,7,7,7,  7,7,7,7,7, 7,7,7,1,0, 0,0,0,0,0, 0,0,0,0,1,
1,0,0,0,5, 0,0,0,0,0, 0,0,0,0,0, 1,7,7,7,7,  7,7,7,7,7, 7,7,7,1,0, 0,0,0,0,0, 0,0,0,0,1,
7,1,1,1,1, 1,1,1,1,1, 1,1,1,1,1, 7,7,7,7,7,  7,7,7,7,7, 7,7,7,7,1, 1,1,1,1,1, 1,1,1,1,7

0...空白　1...ブロック　2...ドラ&ドロ　3...コピー　4...破壊　5...梯子　6...ゴール
